# NOTES:
# The # Symbol at the start of a line counts as a Comment. To include in dialog, use a \#
# The . Symbol will cause a pause unless escaped with \. (ex: Mr. Oshiro has a pause, Mr\. Oshiro does not)
# Newlines automatically create a Page Break, unless there is an {n} command on the previous line
# Commands: Anything inside of curly braces {...} is a command and should not be translated.

# Inline Text Commands:
# {~}wavy text{/~}
# {!}impact text{/!}
# {>> x}changes speed at which characters are displayed{>>}
# {# 000000}this text is black{#} (uses HEX color values)
# {+MENU_BEGIN} inserts the dialog from the MENU_BEGIN value (in English, "CLIMB")
# {n} creates a newline, without a page break
# {0.5} creates a 0.5 second pause
# {big}this text is large{/big}

# Gameplay Control Commands (should never change)
# {trigger x} this triggers an in-game event
# {anchor} controls the visual position of the textbox in-game

MODNAME_EXTENDEDVARIANTMODE=	Extended Variant Mode
MODOPTIONS_EXTENDEDVARIANTS_TITLE=	Extended Variant Mode

POSTCARD_EXTENDEDVARIANTS_FORCEENABLED=	You are entering a map that uses {# 9B3FB5}Extended Variant Mode{#}.{n}{n}For this map to work, {# 9B3FB5}Extended Variants{#} have been enabled and reset to their default values.

MODOPTIONS_EXTENDEDVARIANTS_HEADING=	Variants
MODOPTIONS_EXTENDEDVARIANTS_HEADING_DASHING=	Dashing
MODOPTIONS_EXTENDEDVARIANTS_HEADING_JUMPING=	Jumping
MODOPTIONS_EXTENDEDVARIANTS_HEADING_VERTICALSPEED=	Vertical speed
MODOPTIONS_EXTENDEDVARIANTS_HEADING_MOVING=	Moving around
MODOPTIONS_EXTENDEDVARIANTS_HEADING_CHASERS=	Badeline Chasers
MODOPTIONS_EXTENDEDVARIANTS_HEADING_BOSSES=	Badeline Bosses
MODOPTIONS_EXTENDEDVARIANTS_HEADING_OSHIRO=	Oshiro
MODOPTIONS_EXTENDEDVARIANTS_HEADING_THEO=	Theo Crystals
MODOPTIONS_EXTENDEDVARIANTS_HEADING_OTHER=	Gameplay Tweaks
MODOPTIONS_EXTENDEDVARIANTS_HEADING_TROLL=	Troll Variants
MODOPTIONS_EXTENDEDVARIANTS_HEADING_EVERYWHERE=	Other Game Elements
MODOPTIONS_EXTENDEDVARIANTS_HEADING_MADELINE=	Madeline Visual Modifications
MODOPTIONS_EXTENDEDVARIANTS_HEADING_LEVEL=	Level Visual Modifications
MODOPTIONS_EXTENDEDVARIANTS_HEADING_RANDOMIZER=	Randomizer

MODOPTIONS_EXTENDEDVARIANTS_SUBMENU_MOVEMENT=	Movement
MODOPTIONS_EXTENDEDVARIANTS_SUBMENU_GAMEELEMENTS=	Game Elements
MODOPTIONS_EXTENDEDVARIANTS_SUBMENU_VISUAL=	Visual
MODOPTIONS_EXTENDEDVARIANTS_SUBMENU_GAMEPLAYTWEAKS=	Gameplay Tweaks

MODOPTIONS_EXTENDEDVARIANTS_OPTIONSOUTOFMODOPTIONSMENU=	Variant options in separate menu
MODOPTIONS_EXTENDEDVARIANTS_SUBMENUFOREACHCATEGORY=	Submenu for each category
MODOPTIONS_EXTENDEDVARIANTS_PAUSEMENU_BUTTON=	Extended Variants
MODOPTIONS_EXTENDEDVARIANTS_MODOPTIONS_BUTTON=	Extended Variants Settings

MODOPTIONS_EXTENDEDVARIANTS_MASTERSWITCH=	Enabled
MODOPTIONS_EXTENDEDVARIANTS_GRAVITY=	Gravity
MODOPTIONS_EXTENDEDVARIANTS_FALLSPEED=	Max fall speed
MODOPTIONS_EXTENDEDVARIANTS_JUMPHEIGHT=	Jump height
MODOPTIONS_EXTENDEDVARIANTS_JUMPDURATION=	Max Jump Duration
MODOPTIONS_EXTENDEDVARIANTS_SPEEDX=	Horizontal speed
MODOPTIONS_EXTENDEDVARIANTS_STAMINA=	Stamina (default 110)
MODOPTIONS_EXTENDEDVARIANTS_DASHSPEED=	Dash speed
MODOPTIONS_EXTENDEDVARIANTS_LEGACYDASHSPEEDBEHAVIOR=	Legacy Dash Speed Behavior
MODOPTIONS_EXTENDEDVARIANTS_LEGACYDASHSPEEDBEHAVIOR_HINT=	Intended for "Teleport Mode" TASes, leaving off is recommended otherwise
MODOPTIONS_EXTENDEDVARIANTS_DASHCOUNT=	Dash count
MODOPTIONS_EXTENDEDVARIANTS_CORNERCORRECTION=	Corner Correction (default 4px)
MODOPTIONS_EXTENDEDVARIANTS_DISABLEDASHCOOLDOWN=	Disable Dash Cooldown
MODOPTIONS_EXTENDEDVARIANTS_FRICTION=	Ground Friction
MODOPTIONS_EXTENDEDVARIANTS_AIRFRICTION=	Air Friction
MODOPTIONS_EXTENDEDVARIANTS_DEFAULT=	Default
MODOPTIONS_EXTENDEDVARIANTS_DISABLEWALLJUMPING=	Disable wall jumping
MODOPTIONS_EXTENDEDVARIANTS_DISABLECLIMBJUMPING=	Disable climb jumping
MODOPTIONS_EXTENDEDVARIANTS_DISABLEJUMPINGOUTOFWATER=	Disable jumping out of water
MODOPTIONS_EXTENDEDVARIANTS_JUMPCOUNT=	Jump count
MODOPTIONS_EXTENDEDVARIANTS_INFINITE=	Infinite
MODOPTIONS_EXTENDEDVARIANTS_RESETTODEFAULT_EXTENDED=	Reset Extended Variants to default values
MODOPTIONS_EXTENDEDVARIANTS_RESETTODEFAULT_VANILLA=	Reset Vanilla Variants to default values
MODOPTIONS_EXTENDEDVARIANTS_UPSIDEDOWN=	Upside Down
MODOPTIONS_EXTENDEDVARIANTS_HYPERDASHSPEED=	Hyperdash speed
MODOPTIONS_EXTENDEDVARIANTS_WALLBOUNCINGSPEED=	Wallbouncing speed
MODOPTIONS_EXTENDEDVARIANTS_WALLSLIDINGSPEED=	Wall sliding speed
MODOPTIONS_EXTENDEDVARIANTS_DASHLENGTH=	Dash duration
MODOPTIONS_EXTENDEDVARIANTS_DASHTIMERMULTIPLIER=	Dash Timer Multiplier
MODOPTIONS_EXTENDEDVARIANTS_DASHTIMERMULTIPLIER_DESCRIPTION=	Time during which the game considers you are dashing
MODOPTIONS_EXTENDEDVARIANTS_FORCEDUCKONGROUND=	Force Duck on Ground
MODOPTIONS_EXTENDEDVARIANTS_INVERTDASHES=	Invert Dashes
MODOPTIONS_EXTENDEDVARIANTS_INVERTGRAB=     Invert Grab   
MODOPTIONS_EXTENDEDVARIANTS_DISABLENEUTRALJUMPING=	Disable neutral jumping
MODOPTIONS_EXTENDEDVARIANTS_CHANGEVARIANTSRANDOMLY=	Change Variants Randomly
MODOPTIONS_EXTENDEDVARIANTS_OFF=	Off
MODOPTIONS_EXTENDEDVARIANTS_VANILLA=	Vanilla
MODOPTIONS_EXTENDEDVARIANTS_EXTENDED=	Extended
MODOPTIONS_EXTENDEDVARIANTS_BOTH=	Both
MODOPTIONS_EXTENDEDVARIANTS_CHANGEVARIANTSINTERVAL=	Modify variants...
MODOPTIONS_EXTENDEDVARIANTS_ONSCREENTRANSITION=	On Each Screen
MODOPTIONS_EXTENDEDVARIANTS_EVERY=	Every
MODOPTIONS_EXTENDEDVARIANTS_BADELINECHASERSEVERYWHERE=	Badeline Chasers Everywhere
MODOPTIONS_EXTENDEDVARIANTS_CHASERCOUNT=	Chaser Count
MODOPTIONS_EXTENDEDVARIANTS_AFFECTEXISTINGCHASERS=	Affect Existing Chasers
MODOPTIONS_EXTENDEDVARIANTS_REGULARHICCUPS=	Hiccups every...
MODOPTIONS_EXTENDEDVARIANTS_HICCUPSTRENGTH=	Hiccup Strength
MODOPTIONS_EXTENDEDVARIANTS_DISABLED=	Disabled
MODOPTIONS_EXTENDEDVARIANTS_REFILLJUMPSONDASHREFILL=	Refill Jumps on Dash Refill
MODOPTIONS_EXTENDEDVARIANTS_ROOMLIGHTING=	Room Lighting
MODOPTIONS_EXTENDEDVARIANTS_ROOMBLOOM=	Room Bloom
MODOPTIONS_EXTENDEDVARIANTS_GLITCHEFFECT=	Glitch Effect
MODOPTIONS_EXTENDEDVARIANTS_ANXIETYEFFECT=	Anxiety Effect
MODOPTIONS_EXTENDEDVARIANTS_BLURLEVEL=	Blur Effect
MODOPTIONS_EXTENDEDVARIANTS_BACKGROUNDBLURLEVEL=	Background Blur Effect
MODOPTIONS_EXTENDEDVARIANTS_ZOOMLEVEL=	Zoom Level
MODOPTIONS_EXTENDEDVARIANTS_OSHIROEVERYWHERE=	Oshiro Everywhere
MODOPTIONS_EXTENDEDVARIANTS_OSHIROCOUNT=	Oshiro Count
MODOPTIONS_EXTENDEDVARIANTS_REVERSEOSHIROCOUNT=	Reverse Oshiro Count
MODOPTIONS_EXTENDEDVARIANTS_DISABLEOSHIROSLOWDOWN=	Disable Oshiro Slowdown
MODOPTIONS_EXTENDEDVARIANTS_WINDEVERYWHERE=	Wind Everywhere
MODOPTIONS_EXTENDEDVARIANTS_WINDEVERYWHERE_NONE=	No Wind
MODOPTIONS_EXTENDEDVARIANTS_WINDEVERYWHERE_LEFT=	Left
MODOPTIONS_EXTENDEDVARIANTS_WINDEVERYWHERE_RIGHT=	Right
MODOPTIONS_EXTENDEDVARIANTS_WINDEVERYWHERE_LEFTSTRONG=	Left Strong
MODOPTIONS_EXTENDEDVARIANTS_WINDEVERYWHERE_RIGHTSTRONG=	Right Strong
MODOPTIONS_EXTENDEDVARIANTS_WINDEVERYWHERE_LEFTONOFF=	Left On/Off
MODOPTIONS_EXTENDEDVARIANTS_WINDEVERYWHERE_RIGHTONOFF=	Right On/Off
MODOPTIONS_EXTENDEDVARIANTS_WINDEVERYWHERE_LEFTONOFFFAST=	Left On/Off Fast
MODOPTIONS_EXTENDEDVARIANTS_WINDEVERYWHERE_RIGHTONOFFFAST=	Right On/Off Fast
MODOPTIONS_EXTENDEDVARIANTS_WINDEVERYWHERE_ALTERNATING=	Alternating
MODOPTIONS_EXTENDEDVARIANTS_WINDEVERYWHERE_DOWN=	Down
MODOPTIONS_EXTENDEDVARIANTS_WINDEVERYWHERE_UP=	Up
MODOPTIONS_EXTENDEDVARIANTS_WINDEVERYWHERE_RIGHTCRAZY=	Right Crazy
MODOPTIONS_EXTENDEDVARIANTS_WINDEVERYWHERE_RANDOM=	Random
MODOPTIONS_EXTENDEDVARIANTS_SNOWBALLSEVERYWHERE=	Snowballs Everywhere
MODOPTIONS_EXTENDEDVARIANTS_SNOWBALLDELAY=	Snowball Delay (default 0.8s)
MODOPTIONS_EXTENDEDVARIANTS_ADDSEEKERS=	Add Seekers
MODOPTIONS_EXTENDEDVARIANTS_DISABLESEEKERSLOWDOWN=	Disable Seeker Slowdown
MODOPTIONS_EXTENDEDVARIANTS_BADELINELAG=	Delay between Badeline and Player
MODOPTIONS_EXTENDEDVARIANTS_DELAYBETWEENBADELINES=	Delay between Badelines (default 0.4s)
MODOPTIONS_EXTENDEDVARIANTS_HELDDASH=	Held Dash
MODOPTIONS_EXTENDEDVARIANTS_ALLSTRAWBERRIESAREGOLDENS=	All Strawberries are Goldens
MODOPTIONS_EXTENDEDVARIANTS_DONTREFILLDASHONGROUND=	Don't Refill Dash on Ground
MODOPTIONS_EXTENDEDVARIANTS_GAMESPEED=	Game Speed
MODOPTIONS_EXTENDEDVARIANTS_EVERYTHINGISUNDERWATER=	Everything is Underwater
MODOPTIONS_EXTENDEDVARIANTS_SUPERDASHSTEERINGSPEED=	Super Dash variant - Steering Speed

MODOPTIONS_EXTENDEDVARIANTS_DONTREFILLSTAMINAONGROUND=	Don't Refill Stamina on Ground

MODOPTIONS_EXTENDEDVARIANTS_THEOCRYSTALSEVERYWHERE=	Theo Crystals Everywhere
MODOPTIONS_EXTENDEDVARIANTS_AllowThrowingTheoOffscreen=	Allow Throwing Theo Offscreen
MODOPTIONS_EXTENDEDVARIANTS_AllowThrowingTheoOffscreen_desc1=
	On = You can only go to the room you threw Theo in
MODOPTIONS_EXTENDEDVARIANTS_AllowThrowingTheoOffscreen_desc2=
	Off = Theo bounces on screen borders and you must carry him
MODOPTIONS_EXTENDEDVARIANTS_AllowLeavingTheoBehind=	Allow Leaving Theo Behind

MODOPTIONS_EXTENDEDVARIANTS_BADELINEBOSSESEVERYWHERE=	Badeline Bosses Everywhere
MODOPTIONS_EXTENDEDVARIANTS_BADELINEATTACKPATTERN=	Badeline Attack Pattern
MODOPTIONS_EXTENDEDVARIANTS_CHANGEPATTERNSOFEXISTINGBOSSES=	Change Pattern of Existing Bosses
MODOPTIONS_EXTENDEDVARIANTS_FIRSTBADELINESPAWNRANDOM=	First Badeline Spawn Position
MODOPTIONS_EXTENDEDVARIANTS_FIRSTBADELINESPAWNRANDOM_OFF=	Opposite of Room
MODOPTIONS_EXTENDEDVARIANTS_FIRSTBADELINESPAWNRANDOM_ON=	Random
MODOPTIONS_EXTENDEDVARIANTS_BADELINEBOSSCOUNT=	Badeline Boss Count
MODOPTIONS_EXTENDEDVARIANTS_BADELINEBOSSNODECOUNT=	Badeline Boss Position Count
MODOPTIONS_EXTENDEDVARIANTS_BADELINEPATTERN_1=	Slow shots
MODOPTIONS_EXTENDEDVARIANTS_BADELINEPATTERN_2=	Beam > Shot
MODOPTIONS_EXTENDEDVARIANTS_BADELINEPATTERN_3=	Fast double-shots
MODOPTIONS_EXTENDEDVARIANTS_BADELINEPATTERN_4=	Double-shots > Beam
MODOPTIONS_EXTENDEDVARIANTS_BADELINEPATTERN_5=	Beam > Double-shots
MODOPTIONS_EXTENDEDVARIANTS_BADELINEPATTERN_9=	Slow double-shots
MODOPTIONS_EXTENDEDVARIANTS_BADELINEPATTERN_10=	Nothing
MODOPTIONS_EXTENDEDVARIANTS_BADELINEPATTERN_14=	Fast beam
MODOPTIONS_EXTENDEDVARIANTS_BADELINEPATTERN_15=	Slow beam

MODOPTIONS_EXTENDEDVARIANTS_COLORGRADING=	Color Grading
MODOPTIONS_EXTENDEDVARIANTS_CG_NONE=	None
MODOPTIONS_EXTENDEDVARIANTS_CG_COLD=	Cold
MODOPTIONS_EXTENDEDVARIANTS_CG_HOT=	Hot
MODOPTIONS_EXTENDEDVARIANTS_CG_CREDITS=	Credits
MODOPTIONS_EXTENDEDVARIANTS_CG_FEELINGDOWN=	Feeling Down
MODOPTIONS_EXTENDEDVARIANTS_CG_GOLDEN=	Golden
MODOPTIONS_EXTENDEDVARIANTS_CG_OLDSITE=	Old Site
MODOPTIONS_EXTENDEDVARIANTS_CG_PANICATTACK=	Panic Attack
MODOPTIONS_EXTENDEDVARIANTS_CG_REFLECTION=	Reflection
MODOPTIONS_EXTENDEDVARIANTS_CG_TEMPLEVOID=	Temple Void
MODOPTIONS_EXTENDEDVARIANTS_CG_TETRIS=	Tetris (Celsius)
MODOPTIONS_EXTENDEDVARIANTS_CG_INVERTED=	Inverted Colors
MODOPTIONS_EXTENDEDVARIANTS_CG_GREYSCALE=	Black & White
MODOPTIONS_EXTENDEDVARIANTS_CG_SEPIA=	Sepia
MODOPTIONS_EXTENDEDVARIANTS_CG_RGBSHIFT1=	Recolor (1)
MODOPTIONS_EXTENDEDVARIANTS_CG_RGBSHIFT2=	Recolor (2)
MODOPTIONS_EXTENDEDVARIANTS_CG_HOLLYS_RANDOMNOISE=	Corrupted
MODOPTIONS_EXTENDEDVARIANTS_CG_TRIGGER=	Defined by Custom Map

MODOPTIONS_EXTENDEDVARIANTS_JELLYFISHEVERYWHERE=	Jellyfish Everywhere
MODOPTIONS_EXTENDEDVARIANTS_RISINGLAVAEVERYWHERE=	Rising Lava / Falling Ice Everywhere
MODOPTIONS_EXTENDEDVARIANTS_RISINGLAVASPEED=	Lava / Ice Speed

MODOPTIONS_EXTENDEDVARIANTS_EXPLODELAUNCHSPEED=	Explode Launch Speed
MODOPTIONS_EXTENDEDVARIANTS_DISABLESUPERBOOSTS=	Disable Super Boosts
MODOPTIONS_EXTENDEDVARIANTS_DISABLESUPERBOOSTS_NOTE=	(boost you can get by pressing in the direction you're getting launched to)

MODOPTIONS_EXTENDEDVARIANTS_HORIZONTALSPRINGBOUNCEDURATION=	Horizontal Spring Bounce Duration
MODOPTIONS_EXTENDEDVARIANTS_HORIZONTALWALLJUMPDURATION=	Horizontal Wall Jump Duration
MODOPTIONS_EXTENDEDVARIANTS_HORIZONTALWALLJUMPDURATION_HINT=	Does not apply to neutral jumps

MODOPTIONS_EXTENDEDVARIANTS_INVERTHORIZONTALCONTROLS=	Invert Horizontal Controls
MODOPTIONS_EXTENDEDVARIANTS_INVERTVERTICALCONTROLS=	Invert Vertical Controls

MODOPTIONS_EXTENDEDVARIANTS_BOUNCEEVERYWHERE=	Bounce Everywhere
MODOPTIONS_EXTENDEDVARIANTS_SCREENSHAKEINTENSITY=	Screen Shake Intensity (:extendedvariants_warning:SEIZURE)

MODOPTIONS_EXTENDEDVARIANTS_JUNGLESPIDERSEVERYWHERE= Jungle Spiders Everywhere
MODOPTIONS_EXTENDEDVARIANTS_JUNGLESPIDERSEVERYWHERE_DISABLED=	Disabled
MODOPTIONS_EXTENDEDVARIANTS_JUNGLESPIDERSEVERYWHERE_BLUE=		Blue
MODOPTIONS_EXTENDEDVARIANTS_JUNGLESPIDERSEVERYWHERE_PURPLE=		Purple
MODOPTIONS_EXTENDEDVARIANTS_JUNGLESPIDERSEVERYWHERE_RED=		Red

MODOPTIONS_EXTENDEDVARIANTS_DASHDIRECTION=	Dash Direction
MODOPTIONS_EXTENDEDVARIANTS_DASHDIRECTION_0=	All Directions
MODOPTIONS_EXTENDEDVARIANTS_DASHDIRECTION_1=	No Diagonals
MODOPTIONS_EXTENDEDVARIANTS_DASHDIRECTION_2=	Diagonals Only
MODOPTIONS_EXTENDEDVARIANTS_DASHDIRECTION_3=	Custom
MODOPTIONS_EXTENDEDVARIANTS_DASHDIRECTION_ALLOWED=	Allowed Dash Directions
MODOPTIONS_EXTENDEDVARIANTS_DASHDIRECTION_TOPLEFT=	Top-Left
MODOPTIONS_EXTENDEDVARIANTS_DASHDIRECTION_TOP=	Top
MODOPTIONS_EXTENDEDVARIANTS_DASHDIRECTION_TOPRIGHT=	Top-Right
MODOPTIONS_EXTENDEDVARIANTS_DASHDIRECTION_RIGHT=	Right
MODOPTIONS_EXTENDEDVARIANTS_DASHDIRECTION_BOTTOMRIGHT=	Bottom-Right
MODOPTIONS_EXTENDEDVARIANTS_DASHDIRECTION_BOTTOM=	Bottom
MODOPTIONS_EXTENDEDVARIANTS_DASHDIRECTION_BOTTOMLEFT=	Bottom-Left
MODOPTIONS_EXTENDEDVARIANTS_DASHDIRECTION_LEFT=	Left

MODOPTIONS_EXTENDEDVARIANTS_BACKGROUNDBRIGHTNESS=	Background Brightness

MODOPTIONS_EXTENDEDVARIANTS_DISABLEMADELINESPOTLIGHT=	Disable Madeline's Spotlight

MODOPTIONS_EXTENDEDVARIANTS_DISABLEKEYSSPOTLIGHT=	Disable Keys Spotlight

MODOPTIONS_EXTENDEDVARIANTS_FOREGROUNDEFFECTOPACITY=	Foreground Effect Opacity

MODOPTIONS_EXTENDEDVARIANTS_MADELINEISSILHOUETTE=	Madeline is a Silhouette
MODOPTIONS_EXTENDEDVARIANTS_DASHTRAILALLTHETIME=	Dash Trail All The Time
MODOPTIONS_EXTENDEDVARIANTS_MADELINEHASPONYTAIL=	Madeline has a Ponytail

MODOPTIONS_EXTENDEDVARIANTS_DISABLECLIMBINGUPORDOWN=	Disable Climbing Up or Down

MODOPTIONS_EXTENDEDVARIANTS_MADELINEBACKPACKMODE= Madeline's Backpack
MODOPTIONS_EXTENDEDVARIANTS_MADELINEBACKPACKMODE_DEFAULT= Default
MODOPTIONS_EXTENDEDVARIANTS_MADELINEBACKPACKMODE_BACKPACK= With Backpack
MODOPTIONS_EXTENDEDVARIANTS_MADELINEBACKPACKMODE_NOBACKPACK= No Backpack

MODOPTIONS_EXTENDEDVARIANTS_HEADING_HOLDABLES= Holdable Items

MODOPTIONS_EXTENDEDVARIANTS_PICKUPDURATION= Pickup Duration
MODOPTIONS_EXTENDEDVARIANTS_MINIMUMDELAYBEFORETHROWING= Minimum Delay Before Throwing
MODOPTIONS_EXTENDEDVARIANTS_DELAYBEFOREREGRABBING= Delay Before Regrabbing

MODOPTIONS_EXTENDEDVARIANTS_SWIMMINGSPEED=	Swimming Speed

MODOPTIONS_EXTENDEDVARIANTS_BOOSTMULTIPLIER=	Boost Multiplier

MODOPTIONS_EXTENDEDVARIANTS_FRIENDLYBADELINEFOLLOWER=	Friendly Badeline Follower

MODOPTIONS_EXTENDEDVARIANTS_DISABLEREFILLSONSCREENTRANSITION=	Disable Refills on Screen Transition
MODOPTIONS_EXTENDEDVARIANTS_RESTOREDASHESONRESPAWN=	Restore Dashes on Respawn
MODOPTIONS_EXTENDEDVARIANTS_RESTOREDASHESONRESPAWN_NOTE=	If you had 1 dash when you reached the spawn point, you will respawn with 1 dash

MODOPTIONS_EXTENDEDVARIANTS_DISPLAYDASHCOUNT=	Display Dash Count

MODOPTIONS_EXTENDEDVARIANTS_EVERYJUMPISULTRA=	Every Jump is an Ultra
MODOPTIONS_EXTENDEDVARIANTS_EVERYJUMPISULTRA_DESC=	Get a 1.2x horizontal speed boost and duck when jumping

MODOPTIONS_EXTENDEDVARIANTS_COYOTETIME=	Coyote Time
MODOPTIONS_EXTENDEDVARIANTS_COYOTETIME_DESC=	Time during which you can jump in midair after walking off a platform

MODOPTIONS_EXTENDEDVARIANTS_NOFREEZEFRAMES=	No Freeze Frames
MODOPTIONS_EXTENDEDVARIANTS_NOFREEZEFRAMES_DESC=	Don't freeze the game for a few frames when dashing, collecting a refill, etc.

MODOPTIONS_EXTENDEDVARIANTS_PRESERVEEXTRADASHESUNDERWATER=	Preserve Extra Dashes Underwater

MODOPTIONS_EXTENDEDVARIANTS_ALWAYSINVISIBLE= Madeline is Always Invisible

MODOPTIONS_EXTENDEDVARIANTS_DISPLAYSPEEDOMETER= Display Speedometer
MODOPTIONS_EXTENDEDVARIANTS_DISPLAYSPEEDOMETER_DISABLED= Disabled
MODOPTIONS_EXTENDEDVARIANTS_DISPLAYSPEEDOMETER_HORIZONTAL= Horizontal
MODOPTIONS_EXTENDEDVARIANTS_DISPLAYSPEEDOMETER_VERTICAL= Vertical
MODOPTIONS_EXTENDEDVARIANTS_DISPLAYSPEEDOMETER_BOTH= Both

MODOPTIONS_EXTENDEDVARIANTS_AutomaticallyResetVariants= Automatically Reset Variants
MODOPTIONS_EXTENDEDVARIANTS_AutomaticallyResetVariants_description= when entering a map using Extended Variants

MODOPTIONS_EXTENDEDVARIANTS_RANDOMIZER=	Randomizer Options
MODOPTIONS_EXTENDEDVARIANTS_RANDOMIZERTITLE=	RANDOMIZER OPTIONS
MODOPTIONS_EXTENDEDVARIANTS_RANDOMIZER_ENABLED_VANILLA=	Select randomized vanilla variants
MODOPTIONS_EXTENDEDVARIANTS_RANDOMIZER_ENABLED_EXTENDED=	Select randomized extended variants
MODOPTIONS_EXTENDEDVARIANTS_RANDOMIZER_GENERALSETTINGS=	General Settings
MODOPTIONS_EXTENDEDVARIANTS_RANDOMIZER_VARIANTSET=	Variants to randomize
MODOPTIONS_EXTENDEDVARIANTS_RANDOMIZER_REROLLMODE=	Reroll Mode
MODOPTIONS_EXTENDEDVARIANTS_RANDOMIZER_MAXENABLEDVARIANTS=	Max variant count to enable
MODOPTIONS_EXTENDEDVARIANTS_RANDOMIZER_MAXENABLEDVARIANTS_REROLL=	Variants to enable at each reroll
MODOPTIONS_EXTENDEDVARIANTS_RANDOMIZER_VANILLAFY=	Disable variants if stuck every...
MODOPTIONS_EXTENDEDVARIANTS_RANDOMIZER_DISPLAYONSCREEN=	Display active variants on-screen
MODOPTIONS_EXTENDEDVARIANTS_RANDOMIZER_SETSEED=	Set Seed
MODOPTIONS_EXTENDEDVARIANTS_RANDOMIZER_SEEDINPUT= Seed:
MODOPTIONS_EXTENDEDVARIANTS_RANDOMIZER_SEEDDESCRIPTION1= If you start from the same room with the same seed,
MODOPTIONS_EXTENDEDVARIANTS_RANDOMIZER_SEEDDESCRIPTION2= the variants will be the same